11111
10E01
10001
10P01
11111
