111111111111111
10000000C00E001
100100000000001
100000100C00001
1001C1C10000001
100010000010001
100000P00000001
111111111111111
