11111111111111111111111111111111
1E0CCCC110CP00000001001000000001
11100000000110010010000100001011
10000000000000011100001000100011
10000001011000100000010001000001
10011001000001000000000000001011
10010000001001000100010000001011
10010000010000010100000000100001
11100000001010000001000000000001
10010000000010000001100000100001
10110000001100100100010000001001
10111001010000001010001001100001
10010100101100001101000000101001
10000011000010000101101000000001
10000000000000100100000010100101
11111111111111111111111111111111
